                
################
x              x
x              x
s              b
x              x
x              x
################
                
                
