################
################
#######    #####
####### ## #####
s    ## ##     b
#### ## ########
#### ## ########
####    ########
################
################
