###############s
# # ##  ## ## #b
# # # ## # ## ##
## ## ## # ## ##
## ###  ###  ###
################
# ### #   #  # #
# # # ## ## #  #
## # ##   # ## #
################
