s              #
############## #
#              #
# ##############
#              #
############## #
#              #
# ##############
#              b
################
