s              #
############## #
#        ##### #
# ###### ##### #
# ###### ##### #
# ###### ##### #
# ###### ##### #
# ######       #
# ##############
#              b
