xx##########b#xx
xx#        # #xx
xx# ###### # #xx
xx# #    # # #xx
xx# # ##s# # #xx
xx# # #### # #xx
xx# #      # #xx
xx# ######## #xx
xx#          #xx
xx############xx
