############b###
###        # ###
### ###### # ###
### #    # # ###
### # ##s# # ###
### # #### # ###
### #      # ###
### ######## ###
###          ###
################
